SO ./img/eagle.xpm
NO ./img/eagle.xpm
WE ./img/eagle.xpm
EA ./img/eagle.xpm



F 2,166,48
C 10,241,245



1111111111111111111111111111111111111111111111111111111111111111111
1000000000000000000000000000000000000000000000000000000000000000001
1000000000000000000000000000000000000000000000000000000000000000001
1000000000000011100000000000001000000000000000000000000000000000001
100000000000001 100000000000000000000000000000000000000000010000001
1000000000000011100000000000000000000000000000001111000000000000001
1000000000000000000000000000000000000000000000001  1000000000000001
1000000000000000000000000000000000000000000000001  1000000000000001
1000000000000000000000000000010000000000000000001111000000000000001
1000000000000000000000000000000000000000000000000000000000000000001
1000000000000000000000000000000000000000000000000000000000000000001
1000000000100000000000000000000000000000000000000000000000000000001
1000000000000000000010000000000000000000000000000000000000000000001
10000000000000000000000000000000E0000000000000000000110000000000001
1000000000000000000000000000000000000000000000000000110000000000001
1000000000000000000000000000000000000000000000000000000000000000001
1000000000000000000000000000000000000000000000000000000000000000001
1000000111000000000000000000000000000000011000000000000000000000001
10000001 1000000000000000000000000000000011000000000000000000000001
1000000111000000000000000000000000000000000000000000000000000000001
10000000000000000000000111D1110000000000000000000000000000000000001
1000000000000000000000010000010000000000000000001000000000000000001
1000000000000000000000010000010000000000000000000000000000000000001
1000000000000000000000010010010000000000000000000000000000000000001
1000000000000000000000010000010000000000000000111000000000000000001
1000000000000000000000010000010000000000000000111000000000000000001
1000000000000000000000011111110000000000000000111000000000000000001
1000000000001000000000000000000000000000000000000000000000000000001
1000000000000000000000000000000000000000000000000000000000000000001
1000000000000000000000000000000000000000000000000000000000000000001
1000000000000000000000000000000000000000000000000000000000000000001
1000000000000000000000000000000011000000000000000000000000000000001
1000011110000000000000000000000011000000000000000000000000000000001
1000011110000000000000000000000000000000000000000000000000000000001
1000011110000000000000000000000000000000000000000001000000000000001
1000011110000000000000000000000000000000000000000000000000000000001
1000000000000000000000000000000000000000000000000000000000000000001
1000000000000000001100000000000000000000000000000000000000000000001
1000000000000000001100000000100000000000000000000000000011000000001
1000000000000000000000000000000000000000000000000000000011000000001
1000000000000000000000000000000000000000001110000000000000000000001
1000000000000000000000000000000000000000001 10000000000000000000001
1000010000000000000000000000000000000000001110000000000000000000001
1000000000000000000000000000000000000000000000000000000000000000001
1000000000000000001110000000000000000000000000000000000000000000001
1000000000000000001110000000000000000000000000000000000000000000001
1000000000000000001110000000000000000000000000000000000000000000001
1000000000000000000000000000000000000000000000000000000000000000001
1000111110000000000000000000000010000000000000000000001110000000001
1000100010000000000000000000000000000000000000000000001110000000001
1000D00010000000000000000000000000000000000000000000001110000000001
1000100010000000000000000000000000000000000000000000000000000000001
1000111110000000000000001000000000000000000000000000000000000000001
1000000000000000000000000000000000000000000000000000000000000000001
1111111111111111111111111111111111111111111111111111111111111111111
