SO ./img/eagle.xpm
NO ./img/eagle.xpm
WE ./img/eagle.xpm
EA ./img/eagle.xpm

F 2,166,48
C 10,241,245

111111
100001
100E01
100001
111111
