SO ./img/eagle.xpm
NO ./img/dirt.xpm
WE ./img/magma.xpm
EA ./img/greystone.xpm
F 220,111,119
C 225,111,200

 11111111111111111111111111111111111111
1000000000000000000000000000000000000001
100000000000000000000000000000000000001
1000000000000000000000000000000000000001
1000000000000000000000000000000000000001
1000000000000000001010000000000000000001
1000000000000000001010000000000000000001
1000000000000000001N10010000000000000001
1000000000000000001110010000000000000001
1000000000000000000000000000000000000001
1000000000000000000000000000000000000001
1000000000000000000000000000000000000001
1000000000000000000000000000000000000001
1000000000000000000000000000000000000001
 11111111111111111111111111111111111111
