SO ./img/eagle.xpm
NO ./img/eagle.xpm
WE ./img/eagle.xpm
EA ./img/eagle.xpm



F 2,166,48
C 10,241,245

         111111111111
       1110000000000111
     11100001111110000111
    110000011    110000011
   110000111      111000011
  11000011          11000011
  1000011            1100001
  100001              100001
  10W001              100001
  1000011            1100001
  11000011          11000011
   110000111      111000011
    110000011    110000011
     11100001111110000111
       1100000000000011
        11111111111111
