SO ./img/eagle.xpm
NO ./img/eagle.xpm
WE ./img/eagle.xpm
EA ./img/eagle.xpm

F 2,166,48
C 10,241,245

1111111
1000001
100E001
1000001
1111111
