SO ./img/pillar.xpm
NO ./img/pillar.xpm
WE ./img/pillar.xpm
EA ./img/pillar.xpm



F 2,166,48
C 10,241,2

   1111111111111111111111111
   1000000000000000000100001
1110000001000000000000000001
1000000001111110000000111111
1000100001    10000000000001111
1000000001111110000000001111
1000000000000000000000000001
100000N000000000000000011011
1000001110000000111110010001
1000001110000000000000010001
1111111 11111111111111111111