SO ./img/eagle.xpm
NO ./img/dirt.xpm
WE ./img/magma.xpm
EA ./img/greystone.xpm

F 2,166,48
C 10,241,245

   1111111111111111101111111
   1000000000000000000000001
   1000000000000000000100001
1110000001000000000000000001
1000000001111110000000111111
1000100001    10000000000001111
000000001111110000000001110000000
1000000000000000000000000001
100000E000000000000000011011
1000001110000000111110010001
1000001110000000000000010001
1111111 11111111111011111111